00;empty.png;0
01;grass.png;1
COORD
2;2
MAP
00 00 00 00 00 00 00 00 00 00 00 00 00 00 00
00 01 01 01 01 01 01 01 01 01 01 01 01 01 00
00 01 01 01 01 01 01 01 01 01 01 01 01 01 00
00 01 01 01 01 01 01 01 01 01 01 01 01 01 00
00 01 01 01 00 00 00 00 00 00 00 01 01 01 00
00 01 01 01 00 00 00 00 00 00 00 01 01 01 00
00 01 01 01 00 00 00 00 00 00 00 01 01 01 00
00 01 01 01 00 00 00 00 00 00 00 01 01 01 00
00 01 01 01 00 00 00 00 00 00 00 01 01 01 00
00 01 01 01 00 00 00 00 00 00 00 01 01 01 00
00 01 01 01 00 00 00 00 00 00 00 01 01 01 00
00 01 01 01 01 01 01 01 01 01 01 01 01 01 00
00 01 01 01 01 01 01 01 01 01 01 01 01 01 00
00 01 01 01 01 01 01 01 01 01 01 01 01 01 00
00 00 00 00 00 00 00 00 00 00 00 00 00 00 00
